[{"id":"Abu Dhabi","PopularOs_s":"Android"	,"Count_s":"153"}]
[{"id":"Abu Dhabi","PopularOs_s":"Chrome"	,"Count_s":"12"}]
[{"id":"Abu Dhabi","PopularOs_s":"Mac"	,"Count_s":"4"}]
[{"id":"Abu Dhabi","PopularOs_s":"Windows"	,"Count_s":"23"}]
[{"id":"Abu Dhabi","PopularOs_s":"ios"	,"Count_s":"1"}]
[{"id":"Adelaide","PopularOs_s":"Android"	,"Count_s":"49"}]
[{"id":"Adelaide","PopularOs_s":"Chrome"	,"Count_s":"3"}]
[{"id":"Adelaide","PopularOs_s":"Mac"	,"Count_s":"4"}]
[{"id":"Adelaide","PopularOs_s":"Windows"	,"Count_s":"10"}]
[{"id":"Adelaide","PopularOs_s":"ios"	,"Count_s":"1"}]
[{"id":"Africa/Nairobi","PopularOs_s":"Android"	,"Count_s":"1"}]
[{"id":"Alaska","PopularOs_s":"Android"	,"Count_s":"306"}]
[{"id":"Alaska","PopularOs_s":"Chrome"	,"Count_s":"8"}]
[{"id":"Alaska","PopularOs_s":"Mac"	,"Count_s":"6"}]
[{"id":"Alaska","PopularOs_s":"Windows"	,"Count_s":"32"}]
[{"id":"Alaska","PopularOs_s":"ios"	,"Count_s":"7"}]
[{"id":"Alaska","PopularOs_s":"linux"	,"Count_s":"1"}]
[{"id":"Almaty","PopularOs_s":"Android"	,"Count_s":"27"}]
[{"id":"America/Argentina/Buenos_Aires","PopularOs_s":"Android"	,"Count_s":"2"}]
[{"id":"America/Atikokan","PopularOs_s":"Android"	,"Count_s":"1"}]
[{"id":"America/Caracas","PopularOs_s":"Android"	,"Count_s":"1"}]
[{"id":"America/Chicago","PopularOs_s":"Android"	,"Count_s":"7"}]
[{"id":"America/Denver","PopularOs_s":"Android"	,"Count_s":"1"}]
[{"id":"America/Denver","PopularOs_s":"Chrome"	,"Count_s":"1"}]
[{"id":"America/Detroit","PopularOs_s":"Android"	,"Count_s":"1"}]
[{"id":"America/Los_Angeles","PopularOs_s":"Android"	,"Count_s":"58"}]
[{"id":"America/Los_Angeles","PopularOs_s":"Windows"	,"Count_s":"1"}]
[{"id":"America/New_York","PopularOs_s":"Android"	,"Count_s":"22"}]
[{"id":"America/New_York","PopularOs_s":"Chrome"	,"Count_s":"1"}]
[{"id":"America/New_York","PopularOs_s":"Windows"	,"Count_s":"3"}]
[{"id":"America/New_York","PopularOs_s":"linux"	,"Count_s":"1"}]
[{"id":"America/Phoenix","PopularOs_s":"Android"	,"Count_s":"2"}]
[{"id":"Amsterdam","PopularOs_s":"Android"	,"Count_s":"1217"}]
[{"id":"Amsterdam","PopularOs_s":"Chrome"	,"Count_s":"57"}]
[{"id":"Amsterdam","PopularOs_s":"Mac"	,"Count_s":"39"}]
[{"id":"Amsterdam","PopularOs_s":"Windows"	,"Count_s":"309"}]
[{"id":"Amsterdam","PopularOs_s":"ios"	,"Count_s":"45"}]
[{"id":"Amsterdam","PopularOs_s":"linux"	,"Count_s":"11"}]
[{"id":"Arizona","PopularOs_s":"Android"	,"Count_s":"459"}]
[{"id":"Arizona","PopularOs_s":"Chrome"	,"Count_s":"12"}]
[{"id":"Arizona","PopularOs_s":"Mac"	,"Count_s":"9"}]
[{"id":"Arizona","PopularOs_s":"Windows"	,"Count_s":"60"}]
[{"id":"Arizona","PopularOs_s":"ios"	,"Count_s":"5"}]
[{"id":"Arizona","PopularOs_s":"linux"	,"Count_s":"2"}]
[{"id":"Asia/Calcutta","PopularOs_s":"Android"	,"Count_s":"31"}]
[{"id":"Asia/Calcutta","PopularOs_s":"Chrome"	,"Count_s":"2"}]
[{"id":"Asia/Calcutta","PopularOs_s":"Mac"	,"Count_s":"1"}]
[{"id":"Asia/Calcutta","PopularOs_s":"Windows"	,"Count_s":"11"}]
[{"id":"Astana","PopularOs_s":"Windows"	,"Count_s":"1"}]
[{"id":"Athens","PopularOs_s":"Android"	,"Count_s":"702"}]
[{"id":"Athens","PopularOs_s":"Chrome"	,"Count_s":"14"}]
[{"id":"Athens","PopularOs_s":"Mac"	,"Count_s":"15"}]
[{"id":"Athens","PopularOs_s":"Windows"	,"Count_s":"137"}]
[{"id":"Athens","PopularOs_s":"ios"	,"Count_s":"24"}]
[{"id":"Athens","PopularOs_s":"linux"	,"Count_s":"8"}]
[{"id":"Atlantic Time (Canada)","PopularOs_s":"Android"	,"Count_s":"443"}]
[{"id":"Atlantic Time (Canada)","PopularOs_s":"Chrome"	,"Count_s":"17"}]
[{"id":"Atlantic Time (Canada)","PopularOs_s":"Mac"	,"Count_s":"18"}]
[{"id":"Atlantic Time (Canada)","PopularOs_s":"Windows"	,"Count_s":"83"}]
[{"id":"Atlantic Time (Canada)","PopularOs_s":"ios"	,"Count_s":"31"}]
[{"id":"Atlantic Time (Canada)","PopularOs_s":"linux"	,"Count_s":"1"}]
[{"id":"Auckland","PopularOs_s":"Android"	,"Count_s":"24"}]
[{"id":"Auckland","PopularOs_s":"Chrome"	,"Count_s":"3"}]
[{"id":"Auckland","PopularOs_s":"Mac"	,"Count_s":"1"}]
[{"id":"Auckland","PopularOs_s":"Windows"	,"Count_s":"10"}]
[{"id":"Auckland","PopularOs_s":"ios"	,"Count_s":"3"}]
[{"id":"Auckland","PopularOs_s":"linux"	,"Count_s":"3"}]
[{"id":"Azores","PopularOs_s":"Android"	,"Count_s":"1"}]
[{"id":"Azores","PopularOs_s":"Windows"	,"Count_s":"1"}]
[{"id":"Baghdad","PopularOs_s":"Android"	,"Count_s":"335"}]
[{"id":"Baghdad","PopularOs_s":"Chrome"	,"Count_s":"6"}]
[{"id":"Baghdad","PopularOs_s":"Mac"	,"Count_s":"1"}]
[{"id":"Baghdad","PopularOs_s":"Windows"	,"Count_s":"47"}]
[{"id":"Baghdad","PopularOs_s":"ios"	,"Count_s":"5"}]
[{"id":"Baghdad","PopularOs_s":"linux"	,"Count_s":"3"}]
[{"id":"Baku","PopularOs_s":"Android"	,"Count_s":"11"}]
[{"id":"Bangkok","PopularOs_s":"Android"	,"Count_s":"847"}]
[{"id":"Bangkok","PopularOs_s":"Chrome"	,"Count_s":"37"}]
[{"id":"Bangkok","PopularOs_s":"Mac"	,"Count_s":"16"}]
[{"id":"Bangkok","PopularOs_s":"Windows"	,"Count_s":"91"}]
[{"id":"Bangkok","PopularOs_s":"ios"	,"Count_s":"2"}]
[{"id":"Bangkok","PopularOs_s":"linux"	,"Count_s":"62"}]
[{"id":"Beijing","PopularOs_s":"Android"	,"Count_s":"510"}]
[{"id":"Beijing","PopularOs_s":"Chrome"	,"Count_s":"25"}]
[{"id":"Beijing","PopularOs_s":"Mac"	,"Count_s":"15"}]
[{"id":"Beijing","PopularOs_s":"Windows"	,"Count_s":"71"}]
[{"id":"Beijing","PopularOs_s":"ios"	,"Count_s":"15"}]
[{"id":"Beijing","PopularOs_s":"linux"	,"Count_s":"12"}]
[{"id":"Belgrade","PopularOs_s":"Android"	,"Count_s":"71"}]
[{"id":"Belgrade","PopularOs_s":"Chrome"	,"Count_s":"7"}]
[{"id":"Belgrade","PopularOs_s":"Mac"	,"Count_s":"1"}]
[{"id":"Belgrade","PopularOs_s":"Windows"	,"Count_s":"3"}]
[{"id":"Berlin","PopularOs_s":"Android"	,"Count_s":"167"}]
[{"id":"Berlin","PopularOs_s":"Chrome"	,"Count_s":"21"}]
[{"id":"Berlin","PopularOs_s":"Mac"	,"Count_s":"12"}]
[{"id":"Berlin","PopularOs_s":"Windows"	,"Count_s":"73"}]
[{"id":"Berlin","PopularOs_s":"ios"	,"Count_s":"15"}]
[{"id":"Berlin","PopularOs_s":"linux"	,"Count_s":"15"}]
[{"id":"Bern","PopularOs_s":"Android"	,"Count_s":"27"}]
[{"id":"Bern","PopularOs_s":"Chrome"	,"Count_s":"2"}]
[{"id":"Bern","PopularOs_s":"Mac"	,"Count_s":"2"}]
[{"id":"Bern","PopularOs_s":"Windows"	,"Count_s":"13"}]
[{"id":"Bern","PopularOs_s":"ios"	,"Count_s":"1"}]
[{"id":"Bern","PopularOs_s":"linux"	,"Count_s":"1"}]
[{"id":"Bogota","PopularOs_s":"Android"	,"Count_s":"14"}]
[{"id":"Bogota","PopularOs_s":"Chrome"	,"Count_s":"1"}]
[{"id":"Bogota","PopularOs_s":"Windows"	,"Count_s":"7"}]
[{"id":"Brasilia","PopularOs_s":"Android"	,"Count_s":"271"}]
[{"id":"Brasilia","PopularOs_s":"Chrome"	,"Count_s":"8"}]
[{"id":"Brasilia","PopularOs_s":"Mac"	,"Count_s":"6"}]
[{"id":"Brasilia","PopularOs_s":"Windows"	,"Count_s":"34"}]
[{"id":"Brasilia","PopularOs_s":"ios"	,"Count_s":"3"}]
[{"id":"Brasilia","PopularOs_s":"linux"	,"Count_s":"3"}]
[{"id":"Bratislava","PopularOs_s":"Android"	,"Count_s":"15"}]
[{"id":"Bratislava","PopularOs_s":"Chrome"	,"Count_s":"1"}]
[{"id":"Bratislava","PopularOs_s":"Mac"	,"Count_s":"1"}]
[{"id":"Bratislava","PopularOs_s":"Windows"	,"Count_s":"3"}]
[{"id":"Bratislava","PopularOs_s":"ios"	,"Count_s":"1"}]
[{"id":"Brisbane","PopularOs_s":"Android"	,"Count_s":"121"}]
[{"id":"Brisbane","PopularOs_s":"Chrome"	,"Count_s":"7"}]
[{"id":"Brisbane","PopularOs_s":"Mac"	,"Count_s":"7"}]
[{"id":"Brisbane","PopularOs_s":"Windows"	,"Count_s":"42"}]
[{"id":"Brisbane","PopularOs_s":"ios"	,"Count_s":"1"}]
[{"id":"Brisbane","PopularOs_s":"linux"	,"Count_s":"2"}]
[{"id":"Brussels","PopularOs_s":"Android"	,"Count_s":"85"}]
[{"id":"Brussels","PopularOs_s":"Chrome"	,"Count_s":"6"}]
[{"id":"Brussels","PopularOs_s":"Windows"	,"Count_s":"29"}]
[{"id":"Brussels","PopularOs_s":"linux"	,"Count_s":"4"}]
[{"id":"Bucharest","PopularOs_s":"Android"	,"Count_s":"64"}]
[{"id":"Bucharest","PopularOs_s":"Chrome"	,"Count_s":"7"}]
[{"id":"Bucharest","PopularOs_s":"Mac"	,"Count_s":"5"}]
[{"id":"Bucharest","PopularOs_s":"Windows"	,"Count_s":"35"}]
[{"id":"Bucharest","PopularOs_s":"ios"	,"Count_s":"3"}]
[{"id":"Bucharest","PopularOs_s":"linux"	,"Count_s":"4"}]
[{"id":"Budapest","PopularOs_s":"Android"	,"Count_s":"75"}]
[{"id":"Budapest","PopularOs_s":"Chrome"	,"Count_s":"1"}]
[{"id":"Budapest","PopularOs_s":"Windows"	,"Count_s":"1"}]
[{"id":"Budapest","PopularOs_s":"ios"	,"Count_s":"1"}]
[{"id":"Buenos Aires","PopularOs_s":"Android"	,"Count_s":"36"}]
[{"id":"Buenos Aires","PopularOs_s":"Chrome"	,"Count_s":"2"}]
[{"id":"Buenos Aires","PopularOs_s":"Mac"	,"Count_s":"1"}]
[{"id":"Buenos Aires","PopularOs_s":"Windows"	,"Count_s":"15"}]
[{"id":"Buenos Aires","PopularOs_s":"linux"	,"Count_s":"3"}]
[{"id":"Cairo","PopularOs_s":"Android"	,"Count_s":"77"}]
[{"id":"Cairo","PopularOs_s":"Chrome"	,"Count_s":"4"}]
[{"id":"Cairo","PopularOs_s":"Windows"	,"Count_s":"17"}]
[{"id":"Cairo","PopularOs_s":"ios"	,"Count_s":"4"}]
[{"id":"Canberra","PopularOs_s":"Android"	,"Count_s":"4"}]
[{"id":"Canberra","PopularOs_s":"Windows"	,"Count_s":"1"}]
[{"id":"Cape Verde Is.","PopularOs_s":"Android"	,"Count_s":"2"}]
[{"id":"Caracas","PopularOs_s":"Android"	,"Count_s":"34"}]
[{"id":"Caracas","PopularOs_s":"Chrome"	,"Count_s":"8"}]
[{"id":"Caracas","PopularOs_s":"Mac"	,"Count_s":"3"}]
[{"id":"Caracas","PopularOs_s":"Windows"	,"Count_s":"17"}]
[{"id":"Caracas","PopularOs_s":"linux"	,"Count_s":"1"}]
[{"id":"Casablanca","PopularOs_s":"Android"	,"Count_s":"163"}]
[{"id":"Casablanca","PopularOs_s":"Chrome"	,"Count_s":"7"}]
[{"id":"Casablanca","PopularOs_s":"Mac"	,"Count_s":"8"}]
[{"id":"Casablanca","PopularOs_s":"Windows"	,"Count_s":"53"}]
[{"id":"Casablanca","PopularOs_s":"ios"	,"Count_s":"5"}]
[{"id":"Casablanca","PopularOs_s":"linux"	,"Count_s":"1"}]
[{"id":"Central America","PopularOs_s":"Android"	,"Count_s":"26"}]
[{"id":"Central America","PopularOs_s":"Mac"	,"Count_s":"7"}]
[{"id":"Central America","PopularOs_s":"Windows"	,"Count_s":"10"}]
[{"id":"Central Time (US & Canada)","PopularOs_s":"Android"	,"Count_s":"1534"}]
[{"id":"Central Time (US & Canada)","PopularOs_s":"Chrome"	,"Count_s":"69"}]
[{"id":"Central Time (US & Canada)","PopularOs_s":"Mac"	,"Count_s":"70"}]
[{"id":"Central Time (US & Canada)","PopularOs_s":"Windows"	,"Count_s":"334"}]
[{"id":"Central Time (US & Canada)","PopularOs_s":"ios"	,"Count_s":"26"}]
[{"id":"Central Time (US & Canada)","PopularOs_s":"linux"	,"Count_s":"6"}]
[{"id":"Chennai","PopularOs_s":"Android"	,"Count_s":"1362"}]
[{"id":"Chennai","PopularOs_s":"Chrome"	,"Count_s":"261"}]
[{"id":"Chennai","PopularOs_s":"Mac"	,"Count_s":"112"}]
[{"id":"Chennai","PopularOs_s":"Windows"	,"Count_s":"459"}]
[{"id":"Chennai","PopularOs_s":"ios"	,"Count_s":"50"}]
[{"id":"Chennai","PopularOs_s":"linux"	,"Count_s":"21"}]
[{"id":"Chihuahua","PopularOs_s":"Android"	,"Count_s":"9"}]
[{"id":"Chongqing","PopularOs_s":"Android"	,"Count_s":"1"}]
[{"id":"Copenhagen","PopularOs_s":"Android"	,"Count_s":"54"}]
[{"id":"Copenhagen","PopularOs_s":"Chrome"	,"Count_s":"3"}]
[{"id":"Copenhagen","PopularOs_s":"Mac"	,"Count_s":"6"}]
[{"id":"Copenhagen","PopularOs_s":"Windows"	,"Count_s":"13"}]
[{"id":"Darwin","PopularOs_s":"Android"	,"Count_s":"13"}]
[{"id":"Darwin","PopularOs_s":"Windows"	,"Count_s":"1"}]
[{"id":"Dhaka","PopularOs_s":"Android"	,"Count_s":"27"}]
[{"id":"Dhaka","PopularOs_s":"Chrome"	,"Count_s":"2"}]
[{"id":"Dhaka","PopularOs_s":"Windows"	,"Count_s":"5"}]
[{"id":"Dhaka","PopularOs_s":"ios"	,"Count_s":"2"}]
[{"id":"Dhaka","PopularOs_s":"linux"	,"Count_s":"2"}]
[{"id":"Dublin","PopularOs_s":"Android"	,"Count_s":"46"}]
[{"id":"Dublin","PopularOs_s":"Chrome"	,"Count_s":"4"}]
[{"id":"Dublin","PopularOs_s":"Mac"	,"Count_s":"3"}]
[{"id":"Dublin","PopularOs_s":"Windows"	,"Count_s":"33"}]
[{"id":"Dublin","PopularOs_s":"ios"	,"Count_s":"5"}]
[{"id":"EST","PopularOs_s":"Android"	,"Count_s":"1"}]
[{"id":"Eastern Time (US & Canada)","PopularOs_s":"Android"	,"Count_s":"2272"}]
[{"id":"Eastern Time (US & Canada)","PopularOs_s":"Chrome"	,"Count_s":"130"}]
[{"id":"Eastern Time (US & Canada)","PopularOs_s":"Mac"	,"Count_s":"109"}]
[{"id":"Eastern Time (US & Canada)","PopularOs_s":"Windows"	,"Count_s":"610"}]
[{"id":"Eastern Time (US & Canada)","PopularOs_s":"ios"	,"Count_s":"71"}]
[{"id":"Eastern Time (US & Canada)","PopularOs_s":"linux"	,"Count_s":"30"}]
[{"id":"Edinburgh","PopularOs_s":"Android"	,"Count_s":"138"}]
[{"id":"Edinburgh","PopularOs_s":"Chrome"	,"Count_s":"2"}]
[{"id":"Edinburgh","PopularOs_s":"Mac"	,"Count_s":"4"}]
[{"id":"Edinburgh","PopularOs_s":"Windows"	,"Count_s":"24"}]
[{"id":"Edinburgh","PopularOs_s":"ios"	,"Count_s":"9"}]
[{"id":"Ekaterinburg","PopularOs_s":"Android"	,"Count_s":"7"}]
[{"id":"Ekaterinburg","PopularOs_s":"Windows"	,"Count_s":"23"}]
[{"id":"Europe/Dublin","PopularOs_s":"Android"	,"Count_s":"1"}]
[{"id":"Europe/London","PopularOs_s":"Android"	,"Count_s":"7"}]
[{"id":"Europe/Vilnius","PopularOs_s":"Windows"	,"Count_s":"1"}]
[{"id":"Fiji","PopularOs_s":"Android"	,"Count_s":"1"}]
[{"id":"Georgetown","PopularOs_s":"Android"	,"Count_s":"3"}]
[{"id":"Georgetown","PopularOs_s":"linux"	,"Count_s":"1"}]
[{"id":"Greenland","PopularOs_s":"Android"	,"Count_s":"296"}]
[{"id":"Greenland","PopularOs_s":"Chrome"	,"Count_s":"21"}]
[{"id":"Greenland","PopularOs_s":"Mac"	,"Count_s":"7"}]
[{"id":"Greenland","PopularOs_s":"Windows"	,"Count_s":"49"}]
[{"id":"Greenland","PopularOs_s":"ios"	,"Count_s":"3"}]
[{"id":"Greenland","PopularOs_s":"linux"	,"Count_s":"13"}]
[{"id":"Guadalajara","PopularOs_s":"Android"	,"Count_s":"2"}]
[{"id":"Guadalajara","PopularOs_s":"Windows"	,"Count_s":"4"}]
[{"id":"Hanoi","PopularOs_s":"Android"	,"Count_s":"6"}]
[{"id":"Hanoi","PopularOs_s":"Chrome"	,"Count_s":"7"}]
[{"id":"Hanoi","PopularOs_s":"Windows"	,"Count_s":"7"}]
[{"id":"Hanoi","PopularOs_s":"ios"	,"Count_s":"1"}]
[{"id":"Harare","PopularOs_s":"Android"	,"Count_s":"38"}]
[{"id":"Harare","PopularOs_s":"Chrome"	,"Count_s":"2"}]
[{"id":"Harare","PopularOs_s":"Mac"	,"Count_s":"1"}]
[{"id":"Harare","PopularOs_s":"Windows"	,"Count_s":"5"}]
[{"id":"Harare","PopularOs_s":"ios"	,"Count_s":"3"}]
[{"id":"Hawaii","PopularOs_s":"Android"	,"Count_s":"463"}]
[{"id":"Hawaii","PopularOs_s":"Chrome"	,"Count_s":"24"}]
[{"id":"Hawaii","PopularOs_s":"Mac"	,"Count_s":"9"}]
[{"id":"Hawaii","PopularOs_s":"Windows"	,"Count_s":"108"}]
[{"id":"Hawaii","PopularOs_s":"ios"	,"Count_s":"7"}]
[{"id":"Hawaii","PopularOs_s":"linux"	,"Count_s":"2"}]
[{"id":"Helsinki","PopularOs_s":"Android"	,"Count_s":"52"}]
[{"id":"Helsinki","PopularOs_s":"Chrome"	,"Count_s":"6"}]
[{"id":"Helsinki","PopularOs_s":"Windows"	,"Count_s":"23"}]
[{"id":"Helsinki","PopularOs_s":"ios"	,"Count_s":"1"}]
[{"id":"Helsinki","PopularOs_s":"linux"	,"Count_s":"1"}]
[{"id":"Hobart","PopularOs_s":"Android"	,"Count_s":"10"}]
[{"id":"Hobart","PopularOs_s":"Mac"	,"Count_s":"1"}]
[{"id":"Hobart","PopularOs_s":"Windows"	,"Count_s":"2"}]
[{"id":"Hong Kong","PopularOs_s":"Android"	,"Count_s":"124"}]
[{"id":"Hong Kong","PopularOs_s":"Chrome"	,"Count_s":"9"}]
[{"id":"Hong Kong","PopularOs_s":"Mac"	,"Count_s":"3"}]
[{"id":"Hong Kong","PopularOs_s":"Windows"	,"Count_s":"20"}]
[{"id":"Hong Kong","PopularOs_s":"ios"	,"Count_s":"4"}]
[{"id":"Indiana (East)","PopularOs_s":"Android"	,"Count_s":"46"}]
[{"id":"Indiana (East)","PopularOs_s":"Chrome"	,"Count_s":"2"}]
[{"id":"Indiana (East)","PopularOs_s":"Mac"	,"Count_s":"2"}]
[{"id":"Indiana (East)","PopularOs_s":"Windows"	,"Count_s":"7"}]
[{"id":"International Date Line West","PopularOs_s":"Android"	,"Count_s":"23"}]
[{"id":"International Date Line West","PopularOs_s":"Windows"	,"Count_s":"12"}]
[{"id":"International Date Line West","PopularOs_s":"ios"	,"Count_s":"1"}]
[{"id":"Irkutsk","PopularOs_s":"Android"	,"Count_s":"53"}]
[{"id":"Irkutsk","PopularOs_s":"Chrome"	,"Count_s":"1"}]
[{"id":"Irkutsk","PopularOs_s":"Mac"	,"Count_s":"2"}]
[{"id":"Irkutsk","PopularOs_s":"Windows"	,"Count_s":"8"}]
[{"id":"Irkutsk","PopularOs_s":"ios"	,"Count_s":"1"}]
[{"id":"Irkutsk","PopularOs_s":"linux"	,"Count_s":"2"}]
[{"id":"Islamabad","PopularOs_s":"Android"	,"Count_s":"72"}]
[{"id":"Islamabad","PopularOs_s":"Chrome"	,"Count_s":"6"}]
[{"id":"Islamabad","PopularOs_s":"Mac"	,"Count_s":"5"}]
[{"id":"Islamabad","PopularOs_s":"Windows"	,"Count_s":"25"}]
[{"id":"Islamabad","PopularOs_s":"ios"	,"Count_s":"1"}]
[{"id":"Islamabad","PopularOs_s":"linux"	,"Count_s":"3"}]
[{"id":"Istanbul","PopularOs_s":"Android"	,"Count_s":"147"}]
[{"id":"Istanbul","PopularOs_s":"Chrome"	,"Count_s":"3"}]
[{"id":"Istanbul","PopularOs_s":"Mac"	,"Count_s":"1"}]
[{"id":"Istanbul","PopularOs_s":"Windows"	,"Count_s":"20"}]
[{"id":"Istanbul","PopularOs_s":"ios"	,"Count_s":"1"}]
[{"id":"Istanbul","PopularOs_s":"linux"	,"Count_s":"1"}]
[{"id":"Jakarta","PopularOs_s":"Android"	,"Count_s":"614"}]
[{"id":"Jakarta","PopularOs_s":"Chrome"	,"Count_s":"14"}]
[{"id":"Jakarta","PopularOs_s":"Mac"	,"Count_s":"8"}]
[{"id":"Jakarta","PopularOs_s":"Windows"	,"Count_s":"61"}]
[{"id":"Jakarta","PopularOs_s":"linux"	,"Count_s":"3"}]
[{"id":"Jerusalem","PopularOs_s":"Android"	,"Count_s":"79"}]
[{"id":"Jerusalem","PopularOs_s":"Chrome"	,"Count_s":"4"}]
[{"id":"Jerusalem","PopularOs_s":"Mac"	,"Count_s":"3"}]
[{"id":"Jerusalem","PopularOs_s":"Windows"	,"Count_s":"8"}]
[{"id":"Jerusalem","PopularOs_s":"ios"	,"Count_s":"1"}]
[{"id":"Kabul","PopularOs_s":"Android"	,"Count_s":"2"}]
[{"id":"Kabul","PopularOs_s":"Mac"	,"Count_s":"2"}]
[{"id":"Kabul","PopularOs_s":"Windows"	,"Count_s":"2"}]
[{"id":"Kabul","PopularOs_s":"ios"	,"Count_s":"476"}]
[{"id":"Kamchatka","PopularOs_s":"Windows"	,"Count_s":"3"}]
[{"id":"Karachi","PopularOs_s":"Android"	,"Count_s":"43"}]
[{"id":"Karachi","PopularOs_s":"Chrome"	,"Count_s":"7"}]
[{"id":"Karachi","PopularOs_s":"Mac"	,"Count_s":"4"}]
[{"id":"Karachi","PopularOs_s":"Windows"	,"Count_s":"22"}]
[{"id":"Kathmandu","PopularOs_s":"Android"	,"Count_s":"15"}]
[{"id":"Kathmandu","PopularOs_s":"Chrome"	,"Count_s":"2"}]
[{"id":"Kathmandu","PopularOs_s":"Mac"	,"Count_s":"1"}]
[{"id":"Kathmandu","PopularOs_s":"Windows"	,"Count_s":"5"}]
[{"id":"Kolkata","PopularOs_s":"Android"	,"Count_s":"56"}]
[{"id":"Kolkata","PopularOs_s":"Chrome"	,"Count_s":"9"}]
[{"id":"Kolkata","PopularOs_s":"Mac"	,"Count_s":"4"}]
[{"id":"Kolkata","PopularOs_s":"Windows"	,"Count_s":"15"}]
[{"id":"Kolkata","PopularOs_s":"ios"	,"Count_s":"1"}]
[{"id":"Krasnoyarsk","PopularOs_s":"Android"	,"Count_s":"5"}]
[{"id":"Krasnoyarsk","PopularOs_s":"Windows"	,"Count_s":"2"}]
[{"id":"Kuala Lumpur","PopularOs_s":"Android"	,"Count_s":"434"}]
[{"id":"Kuala Lumpur","PopularOs_s":"Chrome"	,"Count_s":"6"}]
[{"id":"Kuala Lumpur","PopularOs_s":"Mac"	,"Count_s":"12"}]
[{"id":"Kuala Lumpur","PopularOs_s":"Windows"	,"Count_s":"63"}]
[{"id":"Kuala Lumpur","PopularOs_s":"ios"	,"Count_s":"6"}]
[{"id":"Kuala Lumpur","PopularOs_s":"linux"	,"Count_s":"3"}]
[{"id":"Kuwait","PopularOs_s":"Android"	,"Count_s":"42"}]
[{"id":"Kuwait","PopularOs_s":"Chrome"	,"Count_s":"2"}]
[{"id":"Kuwait","PopularOs_s":"Mac"	,"Count_s":"1"}]
[{"id":"Kuwait","PopularOs_s":"Windows"	,"Count_s":"3"}]
[{"id":"Kuwait","PopularOs_s":"ios"	,"Count_s":"1"}]
[{"id":"Kyiv","PopularOs_s":"Android"	,"Count_s":"63"}]
[{"id":"Kyiv","PopularOs_s":"Mac"	,"Count_s":"2"}]
[{"id":"Kyiv","PopularOs_s":"Windows"	,"Count_s":"6"}]
[{"id":"Kyiv","PopularOs_s":"ios"	,"Count_s":"1"}]
[{"id":"La Paz","PopularOs_s":"Android"	,"Count_s":"13"}]
[{"id":"La Paz","PopularOs_s":"Chrome"	,"Count_s":"2"}]
[{"id":"La Paz","PopularOs_s":"Mac"	,"Count_s":"2"}]
[{"id":"La Paz","PopularOs_s":"Windows"	,"Count_s":"4"}]
[{"id":"La Paz","PopularOs_s":"linux"	,"Count_s":"2"}]
[{"id":"Lima","PopularOs_s":"Android"	,"Count_s":"4"}]
[{"id":"Lima","PopularOs_s":"Chrome"	,"Count_s":"1"}]
[{"id":"Lima","PopularOs_s":"Windows"	,"Count_s":"4"}]
[{"id":"Lima","PopularOs_s":"ios"	,"Count_s":"1"}]
[{"id":"Lisbon","PopularOs_s":"Android"	,"Count_s":"95"}]
[{"id":"Lisbon","PopularOs_s":"Chrome"	,"Count_s":"5"}]
[{"id":"Lisbon","PopularOs_s":"Mac"	,"Count_s":"1"}]
[{"id":"Lisbon","PopularOs_s":"Windows"	,"Count_s":"13"}]
[{"id":"Lisbon","PopularOs_s":"linux"	,"Count_s":"1"}]
[{"id":"Ljubljana","PopularOs_s":"Android"	,"Count_s":"12"}]
[{"id":"Ljubljana","PopularOs_s":"Chrome"	,"Count_s":"1"}]
[{"id":"Ljubljana","PopularOs_s":"linux"	,"Count_s":"1"}]
[{"id":"London","PopularOs_s":"Android"	,"Count_s":"1795"}]
[{"id":"London","PopularOs_s":"Chrome"	,"Count_s":"76"}]
[{"id":"London","PopularOs_s":"Mac"	,"Count_s":"68"}]
[{"id":"London","PopularOs_s":"Windows"	,"Count_s":"626"}]
[{"id":"London","PopularOs_s":"ios"	,"Count_s":"51"}]
[{"id":"London","PopularOs_s":"linux"	,"Count_s":"82"}]
[{"id":"Madrid","PopularOs_s":"Android"	,"Count_s":"207"}]
[{"id":"Madrid","PopularOs_s":"Chrome"	,"Count_s":"6"}]
[{"id":"Madrid","PopularOs_s":"Mac"	,"Count_s":"2"}]
[{"id":"Madrid","PopularOs_s":"Windows"	,"Count_s":"30"}]
[{"id":"Madrid","PopularOs_s":"ios"	,"Count_s":"7"}]
[{"id":"Madrid","PopularOs_s":"linux"	,"Count_s":"16"}]
[{"id":"Magadan","PopularOs_s":"Android"	,"Count_s":"1"}]
[{"id":"Marshall Is.","PopularOs_s":"Android"	,"Count_s":"3"}]
[{"id":"Melbourne","PopularOs_s":"Android"	,"Count_s":"84"}]
[{"id":"Melbourne","PopularOs_s":"Chrome"	,"Count_s":"10"}]
[{"id":"Melbourne","PopularOs_s":"Mac"	,"Count_s":"6"}]
[{"id":"Melbourne","PopularOs_s":"Windows"	,"Count_s":"34"}]
[{"id":"Melbourne","PopularOs_s":"ios"	,"Count_s":"6"}]
[{"id":"Melbourne","PopularOs_s":"linux"	,"Count_s":"82"}]
[{"id":"Mexico City","PopularOs_s":"Android"	,"Count_s":"27"}]
[{"id":"Mexico City","PopularOs_s":"Mac"	,"Count_s":"2"}]
[{"id":"Mexico City","PopularOs_s":"Windows"	,"Count_s":"3"}]
[{"id":"Mexico City","PopularOs_s":"ios"	,"Count_s":"1"}]
[{"id":"Mexico City","PopularOs_s":"linux"	,"Count_s":"1"}]
[{"id":"Mid-Atlantic","PopularOs_s":"Android"	,"Count_s":"15"}]
[{"id":"Mid-Atlantic","PopularOs_s":"Chrome"	,"Count_s":"1"}]
[{"id":"Mid-Atlantic","PopularOs_s":"Windows"	,"Count_s":"4"}]
[{"id":"Mid-Atlantic","PopularOs_s":"linux"	,"Count_s":"4"}]
[{"id":"Minsk","PopularOs_s":"Android"	,"Count_s":"6"}]
[{"id":"Minsk","PopularOs_s":"Mac"	,"Count_s":"2"}]
[{"id":"Minsk","PopularOs_s":"Windows"	,"Count_s":"1"}]
[{"id":"Monrovia","PopularOs_s":"Android"	,"Count_s":"2"}]
[{"id":"Monrovia","PopularOs_s":"Windows"	,"Count_s":"1"}]
[{"id":"Monterrey","PopularOs_s":"Android"	,"Count_s":"2"}]
[{"id":"Moscow","PopularOs_s":"Android"	,"Count_s":"62"}]
[{"id":"Moscow","PopularOs_s":"Mac"	,"Count_s":"1"}]
[{"id":"Moscow","PopularOs_s":"Windows"	,"Count_s":"9"}]
[{"id":"Moscow","PopularOs_s":"linux"	,"Count_s":"3"}]
[{"id":"Mountain Time (US & Canada)","PopularOs_s":"Android"	,"Count_s":"314"}]
[{"id":"Mountain Time (US & Canada)","PopularOs_s":"Chrome"	,"Count_s":"13"}]
[{"id":"Mountain Time (US & Canada)","PopularOs_s":"Mac"	,"Count_s":"5"}]
[{"id":"Mountain Time (US & Canada)","PopularOs_s":"Windows"	,"Count_s":"63"}]
[{"id":"Mountain Time (US & Canada)","PopularOs_s":"ios"	,"Count_s":"6"}]
[{"id":"Mountain Time (US & Canada)","PopularOs_s":"linux"	,"Count_s":"1"}]
[{"id":"Mumbai","PopularOs_s":"Android"	,"Count_s":"272"}]
[{"id":"Mumbai","PopularOs_s":"Chrome"	,"Count_s":"42"}]
[{"id":"Mumbai","PopularOs_s":"Mac"	,"Count_s":"13"}]
[{"id":"Mumbai","PopularOs_s":"Windows"	,"Count_s":"86"}]
[{"id":"Mumbai","PopularOs_s":"ios"	,"Count_s":"3"}]
[{"id":"Mumbai","PopularOs_s":"linux"	,"Count_s":"5"}]
[{"id":"Muscat","PopularOs_s":"Android"	,"Count_s":"10"}]
[{"id":"Muscat","PopularOs_s":"Chrome"	,"Count_s":"1"}]
[{"id":"Muscat","PopularOs_s":"Windows"	,"Count_s":"1"}]
[{"id":"Nairobi","PopularOs_s":"Android"	,"Count_s":"69"}]
[{"id":"Nairobi","PopularOs_s":"Chrome"	,"Count_s":"4"}]
[{"id":"Nairobi","PopularOs_s":"Mac"	,"Count_s":"2"}]
[{"id":"Nairobi","PopularOs_s":"Windows"	,"Count_s":"33"}]
[{"id":"Nairobi","PopularOs_s":"linux"	,"Count_s":"2"}]
[{"id":"New Caledonia","PopularOs_s":"Android"	,"Count_s":"46"}]
[{"id":"New Caledonia","PopularOs_s":"Chrome"	,"Count_s":"2"}]
[{"id":"New Caledonia","PopularOs_s":"Windows"	,"Count_s":"3"}]
[{"id":"New Caledonia","PopularOs_s":"ios"	,"Count_s":"1"}]
[{"id":"New Delhi","PopularOs_s":"Android"	,"Count_s":"339"}]
[{"id":"New Delhi","PopularOs_s":"Chrome"	,"Count_s":"40"}]
[{"id":"New Delhi","PopularOs_s":"Mac"	,"Count_s":"12"}]
[{"id":"New Delhi","PopularOs_s":"Windows"	,"Count_s":"118"}]
[{"id":"New Delhi","PopularOs_s":"ios"	,"Count_s":"2"}]
[{"id":"New Delhi","PopularOs_s":"linux"	,"Count_s":"6"}]
[{"id":"Newfoundland","PopularOs_s":"Android"	,"Count_s":"10"}]
[{"id":"Newfoundland","PopularOs_s":"Windows"	,"Count_s":"2"}]
[{"id":"Novosibirsk","PopularOs_s":"Android"	,"Count_s":"2"}]
[{"id":"Nuku'alofa","PopularOs_s":"Android"	,"Count_s":"36"}]
[{"id":"Nuku'alofa","PopularOs_s":"Chrome"	,"Count_s":"1"}]
[{"id":"Osaka","PopularOs_s":"Android"	,"Count_s":"11"}]
[{"id":"Osaka","PopularOs_s":"Windows"	,"Count_s":"5"}]
[{"id":"Pacific Time (US & Canada)","PopularOs_s":"Android"	,"Count_s":"1365"}]
[{"id":"Pacific Time (US & Canada)","PopularOs_s":"Chrome"	,"Count_s":"69"}]
[{"id":"Pacific Time (US & Canada)","PopularOs_s":"Mac"	,"Count_s":"51"}]
[{"id":"Pacific Time (US & Canada)","PopularOs_s":"Windows"	,"Count_s":"405"}]
[{"id":"Pacific Time (US & Canada)","PopularOs_s":"ios"	,"Count_s":"72"}]
[{"id":"Pacific Time (US & Canada)","PopularOs_s":"linux"	,"Count_s":"8"}]
[{"id":"Paris","PopularOs_s":"Android"	,"Count_s":"186"}]
[{"id":"Paris","PopularOs_s":"Chrome"	,"Count_s":"25"}]
[{"id":"Paris","PopularOs_s":"Mac"	,"Count_s":"7"}]
[{"id":"Paris","PopularOs_s":"Windows"	,"Count_s":"80"}]
[{"id":"Paris","PopularOs_s":"ios"	,"Count_s":"8"}]
[{"id":"Paris","PopularOs_s":"linux"	,"Count_s":"13"}]
[{"id":"Perth","PopularOs_s":"Android"	,"Count_s":"31"}]
[{"id":"Perth","PopularOs_s":"Windows"	,"Count_s":"7"}]
[{"id":"Perth","PopularOs_s":"ios"	,"Count_s":"2"}]
[{"id":"Perth","PopularOs_s":"linux"	,"Count_s":"2"}]
[{"id":"Port Moresby","PopularOs_s":"Android"	,"Count_s":"3"}]
[{"id":"Port Moresby","PopularOs_s":"Chrome"	,"Count_s":"2"}]
[{"id":"Port Moresby","PopularOs_s":"Mac"	,"Count_s":"2"}]
[{"id":"Port Moresby","PopularOs_s":"Windows"	,"Count_s":"2"}]
[{"id":"Prague","PopularOs_s":"Android"	,"Count_s":"70"}]
[{"id":"Prague","PopularOs_s":"Chrome"	,"Count_s":"3"}]
[{"id":"Prague","PopularOs_s":"Mac"	,"Count_s":"3"}]
[{"id":"Prague","PopularOs_s":"Windows"	,"Count_s":"10"}]
[{"id":"Prague","PopularOs_s":"ios"	,"Count_s":"3"}]
[{"id":"Prague","PopularOs_s":"linux"	,"Count_s":"2"}]
[{"id":"Pretoria","PopularOs_s":"Android"	,"Count_s":"77"}]
[{"id":"Pretoria","PopularOs_s":"Chrome"	,"Count_s":"5"}]
[{"id":"Pretoria","PopularOs_s":"Mac"	,"Count_s":"4"}]
[{"id":"Pretoria","PopularOs_s":"Windows"	,"Count_s":"24"}]
[{"id":"Pretoria","PopularOs_s":"ios"	,"Count_s":"1"}]
[{"id":"Pretoria","PopularOs_s":"linux"	,"Count_s":"3"}]
[{"id":"Quito","PopularOs_s":"Android"	,"Count_s":"478"}]
[{"id":"Quito","PopularOs_s":"Chrome"	,"Count_s":"20"}]
[{"id":"Quito","PopularOs_s":"Mac"	,"Count_s":"8"}]
[{"id":"Quito","PopularOs_s":"Windows"	,"Count_s":"72"}]
[{"id":"Quito","PopularOs_s":"ios"	,"Count_s":"8"}]
[{"id":"Quito","PopularOs_s":"linux"	,"Count_s":"3"}]
[{"id":"Rangoon","PopularOs_s":"Android"	,"Count_s":"1"}]
[{"id":"Rangoon","PopularOs_s":"Windows"	,"Count_s":"1"}]
[{"id":"Riga","PopularOs_s":"Android"	,"Count_s":"23"}]
[{"id":"Riga","PopularOs_s":"Chrome"	,"Count_s":"1"}]
[{"id":"Riga","PopularOs_s":"Windows"	,"Count_s":"2"}]
[{"id":"Riyadh","PopularOs_s":"Android"	,"Count_s":"104"}]
[{"id":"Riyadh","PopularOs_s":"Chrome"	,"Count_s":"4"}]
[{"id":"Riyadh","PopularOs_s":"Mac"	,"Count_s":"2"}]
[{"id":"Riyadh","PopularOs_s":"Windows"	,"Count_s":"11"}]
[{"id":"Riyadh","PopularOs_s":"ios"	,"Count_s":"1"}]
[{"id":"Rome","PopularOs_s":"Android"	,"Count_s":"185"}]
[{"id":"Rome","PopularOs_s":"Chrome"	,"Count_s":"27"}]
[{"id":"Rome","PopularOs_s":"Mac"	,"Count_s":"6"}]
[{"id":"Rome","PopularOs_s":"Windows"	,"Count_s":"46"}]
[{"id":"Rome","PopularOs_s":"ios"	,"Count_s":"9"}]
[{"id":"Rome","PopularOs_s":"linux"	,"Count_s":"15"}]
[{"id":"Samoa","PopularOs_s":"ios"	,"Count_s":"1"}]
[{"id":"Santiago","PopularOs_s":"Android"	,"Count_s":"87"}]
[{"id":"Santiago","PopularOs_s":"Chrome"	,"Count_s":"3"}]
[{"id":"Santiago","PopularOs_s":"Windows"	,"Count_s":"23"}]
[{"id":"Santiago","PopularOs_s":"ios"	,"Count_s":"3"}]
[{"id":"Sapporo","PopularOs_s":"Android"	,"Count_s":"5"}]
[{"id":"Sapporo","PopularOs_s":"Chrome"	,"Count_s":"1"}]
[{"id":"Sarajevo","PopularOs_s":"Android"	,"Count_s":"4"}]
[{"id":"Sarajevo","PopularOs_s":"Windows"	,"Count_s":"1"}]
[{"id":"Saskatchewan","PopularOs_s":"Android"	,"Count_s":"2"}]
[{"id":"Saskatchewan","PopularOs_s":"Windows"	,"Count_s":"2"}]
[{"id":"Seoul","PopularOs_s":"Android"	,"Count_s":"157"}]
[{"id":"Seoul","PopularOs_s":"Chrome"	,"Count_s":"1"}]
[{"id":"Seoul","PopularOs_s":"Windows"	,"Count_s":"8"}]
[{"id":"Seoul","PopularOs_s":"ios"	,"Count_s":"12"}]
[{"id":"Seoul","PopularOs_s":"linux"	,"Count_s":"1"}]
[{"id":"Singapore","PopularOs_s":"Android"	,"Count_s":"291"}]
[{"id":"Singapore","PopularOs_s":"Chrome"	,"Count_s":"14"}]
[{"id":"Singapore","PopularOs_s":"Mac"	,"Count_s":"22"}]
[{"id":"Singapore","PopularOs_s":"Windows"	,"Count_s":"58"}]
[{"id":"Singapore","PopularOs_s":"ios"	,"Count_s":"7"}]
[{"id":"Singapore","PopularOs_s":"linux"	,"Count_s":"1"}]
[{"id":"Skopje","PopularOs_s":"Android"	,"Count_s":"14"}]
[{"id":"Sofia","PopularOs_s":"Android"	,"Count_s":"46"}]
[{"id":"Sofia","PopularOs_s":"Windows"	,"Count_s":"6"}]
[{"id":"Sri Jayawardenepura","PopularOs_s":"Android"	,"Count_s":"10"}]
[{"id":"Sri Jayawardenepura","PopularOs_s":"Chrome"	,"Count_s":"1"}]
[{"id":"Sri Jayawardenepura","PopularOs_s":"Windows"	,"Count_s":"4"}]
[{"id":"St. Petersburg","PopularOs_s":"Android"	,"Count_s":"8"}]
[{"id":"St. Petersburg","PopularOs_s":"Mac"	,"Count_s":"2"}]
[{"id":"Stockholm","PopularOs_s":"Android"	,"Count_s":"61"}]
[{"id":"Stockholm","PopularOs_s":"Chrome"	,"Count_s":"7"}]
[{"id":"Stockholm","PopularOs_s":"Mac"	,"Count_s":"6"}]
[{"id":"Stockholm","PopularOs_s":"Windows"	,"Count_s":"32"}]
[{"id":"Stockholm","PopularOs_s":"ios"	,"Count_s":"3"}]
[{"id":"Sydney","PopularOs_s":"Android"	,"Count_s":"106"}]
[{"id":"Sydney","PopularOs_s":"Chrome"	,"Count_s":"4"}]
[{"id":"Sydney","PopularOs_s":"Mac"	,"Count_s":"7"}]
[{"id":"Sydney","PopularOs_s":"Windows"	,"Count_s":"30"}]
[{"id":"Sydney","PopularOs_s":"ios"	,"Count_s":"8"}]
[{"id":"Sydney","PopularOs_s":"linux"	,"Count_s":"2"}]
[{"id":"Taipei","PopularOs_s":"Android"	,"Count_s":"48"}]
[{"id":"Taipei","PopularOs_s":"Chrome"	,"Count_s":"8"}]
[{"id":"Taipei","PopularOs_s":"Mac"	,"Count_s":"2"}]
[{"id":"Taipei","PopularOs_s":"Windows"	,"Count_s":"9"}]
[{"id":"Taipei","PopularOs_s":"ios"	,"Count_s":"4"}]
[{"id":"Tallinn","PopularOs_s":"Android"	,"Count_s":"7"}]
[{"id":"Tallinn","PopularOs_s":"Windows"	,"Count_s":"2"}]
[{"id":"Tashkent","PopularOs_s":"Android"	,"Count_s":"2"}]
[{"id":"Tbilisi","PopularOs_s":"Android"	,"Count_s":"1"}]
[{"id":"Tbilisi","PopularOs_s":"Windows"	,"Count_s":"1"}]
[{"id":"Tehran","PopularOs_s":"Android"	,"Count_s":"34"}]
[{"id":"Tehran","PopularOs_s":"Chrome"	,"Count_s":"3"}]
[{"id":"Tehran","PopularOs_s":"Mac"	,"Count_s":"3"}]
[{"id":"Tehran","PopularOs_s":"Windows"	,"Count_s":"10"}]
[{"id":"Tijuana","PopularOs_s":"Android"	,"Count_s":"3"}]
[{"id":"Tijuana","PopularOs_s":"Windows"	,"Count_s":"1"}]
[{"id":"Tokyo","PopularOs_s":"Android"	,"Count_s":"101"}]
[{"id":"Tokyo","PopularOs_s":"Chrome"	,"Count_s":"5"}]
[{"id":"Tokyo","PopularOs_s":"Mac"	,"Count_s":"5"}]
[{"id":"Tokyo","PopularOs_s":"Windows"	,"Count_s":"24"}]
[{"id":"Tokyo","PopularOs_s":"ios"	,"Count_s":"18"}]
[{"id":"Tokyo","PopularOs_s":"linux"	,"Count_s":"1"}]
[{"id":"Ulaan Bataar","PopularOs_s":"Android"	,"Count_s":"1"}]
[{"id":"Ulaan Bataar","PopularOs_s":"Chrome"	,"Count_s":"1"}]
[{"id":"Ulaan Bataar","PopularOs_s":"Windows"	,"Count_s":"1"}]
[{"id":"Vienna","PopularOs_s":"Android"	,"Count_s":"9"}]
[{"id":"Vienna","PopularOs_s":"Mac"	,"Count_s":"2"}]
[{"id":"Vienna","PopularOs_s":"Windows"	,"Count_s":"2"}]
[{"id":"Vilnius","PopularOs_s":"Android"	,"Count_s":"48"}]
[{"id":"Vilnius","PopularOs_s":"Chrome"	,"Count_s":"2"}]
[{"id":"Vilnius","PopularOs_s":"Windows"	,"Count_s":"11"}]
[{"id":"Vladivostok","PopularOs_s":"Android"	,"Count_s":"2"}]
[{"id":"Warsaw","PopularOs_s":"Android"	,"Count_s":"89"}]
[{"id":"Warsaw","PopularOs_s":"Chrome"	,"Count_s":"1"}]
[{"id":"Warsaw","PopularOs_s":"Windows"	,"Count_s":"11"}]
[{"id":"Warsaw","PopularOs_s":"ios"	,"Count_s":"2"}]
[{"id":"Wellington","PopularOs_s":"Android"	,"Count_s":"17"}]
[{"id":"Wellington","PopularOs_s":"Chrome"	,"Count_s":"1"}]
[{"id":"Wellington","PopularOs_s":"Mac"	,"Count_s":"2"}]
[{"id":"Wellington","PopularOs_s":"Windows"	,"Count_s":"4"}]
[{"id":"West Central Africa","PopularOs_s":"Android"	,"Count_s":"83"}]
[{"id":"West Central Africa","PopularOs_s":"Chrome"	,"Count_s":"4"}]
[{"id":"West Central Africa","PopularOs_s":"Mac"	,"Count_s":"5"}]
[{"id":"West Central Africa","PopularOs_s":"Windows"	,"Count_s":"18"}]
[{"id":"West Central Africa","PopularOs_s":"linux"	,"Count_s":"3"}]
[{"id":"Yerevan","PopularOs_s":"Android"	,"Count_s":"2"}]
[{"id":"Yerevan","PopularOs_s":"Chrome"	,"Count_s":"1"}]
[{"id":"Zagreb","PopularOs_s":"Android"	,"Count_s":"18"}]
[{"id":"Zagreb","PopularOs_s":"Chrome"	,"Count_s":"2"}]
[{"id":"Zagreb","PopularOs_s":"Mac"	,"Count_s":"1"}]
[{"id":"Zagreb","PopularOs_s":"Windows"	,"Count_s":"2"}]
[{"id":"Zagreb","PopularOs_s":"ios"	,"Count_s":"1"}]
